1111111111111
1000000000CC1
1000001110001
1P000010E0101
1111111111111