1111111111111
10110000CC001
1000011111001
1P0011CE00001
1111111111111